NO textures/wall_north.xpm
SO textures/wall_south.xpm
WE textures/wall_west.xpm
EA textures/wall_east.xpm
F 100,100,100
C 200,200,200


111111
100001
101001
100N01
111111
